##############################
#s          #                #
#           #     #          #
# ###       # ######         #
# # #       #     #          #
# ###       #                #
#          t# #     #        #
#             #     #        #
#         #   #     #        #
#         #   #     #        #
#         #   #     #        #
#         ########  #        #
#                ###         #
#                            #
##############################
